            
            
            
            
            NO              textures/african/ladys.xpm



SO              textures/african/african_lady_shisha.xpm
WE textures/african/tree.xpm
EA textures/african/s.xpm
F 124, 73, 0 
C 218, 202, 180 


        1111111111111111111111111
        1000000000110000000000001
        101100000111000000000001
        1001000000000000000000001
111111111011000001110000000000001
100000000011000001110111101111111
11110111111111011100000010001
11110111000000000001010010001
11000000000001000100000010001
10001000100000000000001000001
1000000000000N001101010000001
11000001110101000010000000111
11110111111101011111111000001
11111111111111111111111111111