            
            
            
            NO              textures/scary/skull.xpm





SO              textures/scary/nun.xpm
WE textures/scary/skull_wall.xpm
EA textures/scary/wall.xpm
F 20, 25, 9
C 0,0,0


111111111111
10000111111
1 N011111111
100011111111
100011111111
100011111111
100011111111
100011111111
100011111111
100011111111
100011111111
100011111111
100011111111
100011111111
100011111111
100011111111
100011111111
100011111111
100011111111
100011111111
100011111111
100011111111
100011111111
100011111111
100011111111
100011111111
100011111111
100011111111
100011111111
100011111111
100011111111
100011111111
100011111111
100011111111
100011111111
100011111111
100011111111
100011111111
100011111111
100011111111
100011111111
100011111111
100011111111
100011111111
100011111111
100011111111
100011111111
100011111111
100011111111
100011111111
100011111111
100011111111
100011111111
100011111111
100011111111
100011111111
100011111111
100011111111
100011111111
100011111111
100011111111
100011111111
100011111111
100011111111
100011111111
100011111111
100011111111
100011111111
100011111111
100011111111
100011111111
100011111111
100011111111
100011111111
100011111111
100011111111
100011111111
100011111111
100011111111
100011111111
100011111111
100011111111
100011111111
100011111111
100011111111
100011111111
100011111111
100011111111
100011111111
100011111111
100011111111
100011111111
100011111111
100011111111
100011111111
100011111111
100011111111
100011111111
100011111111
100011111111
100011111111
100011111111
100011111111
111111111111